0 0 0 0 0 0 0 262 134 134 263 82 82 82 82 82 82 82 82 82 190 82 82 82 82 82 82 82 82 82 190 82 82 190 82 190 82 190 82 190 82 82 265 266 0 0 0 0 0 0 0 0 0 0 0 0 0 0 0 0 0 0 0 0 0 0 0 0 0 0 0 0 0 0 0 0 0 0 0 0 0 0 0 0 0 0 0 0 0 0
0 0 0 0 0 0 0 0 0 0 262 263 82 82 82 82 82 82 82 82 82 82 82 82 82 82 82 82 82 82 82 82 82 82 82 82 82 82 82 82 82 265 266 0 0 0 0 0 0 0 0 0 0 0 0 0 0 0 0 0 0 0 0 0 0 0 0 0 0 0 0 0 0 0 0 0 0 0 0 0 0 0 0 0 0 0 0 0 0 0
0 0 0 0 0 0 0 0 0 0 0 289 263 82 82 82 82 190 82 82 82 82 82 190 82 82 82 82 82 190 82 82 82 82 82 82 82 82 82 82 265 266 0 0 0 0 0 0 0 0 0 0 0 0 0 0 0 0 0 0 0 0 0 0 0 0 0 0 0 0 0 0 0 0 0 0 0 0 0 0 0 0 0 0 0 0 0 0 0 0
0 0 0 0 0 0 0 0 0 0 0 0 289 263 82 82 82 82 82 82 82 82 82 82 82 82 82 82 82 190 82 82 82 82 82 82 82 82 82 82 84 0 0 0 0 0 0 0 0 0 0 0 0 0 0 0 0 0 0 0 0 0 0 0 0 0 0 0 0 0 0 646 647 648 0 0 0 0 0 0 0 0 0 0 0 0 0 0 0 0
0 0 0 0 0 0 0 0 0 0 0 0 0 289 263 82 82 82 82 190 82 82 82 82 82 82 82 82 82 82 82 82 82 82 82 82 82 82 82 82 84 0 0 0 0 0 0 0 0 0 0 0 0 0 0 0 0 0 0 0 0 0 0 0 0 0 0 0 0 0 671 672 673 674 675 0 0 0 0 0 0 0 0 0 0 0 0 0 0 0
0 0 0 0 0 0 0 0 0 0 0 0 0 0 132 134 134 350 134 134 134 134 350 134 350 346 134 134 134 134 134 134 134 346 134 134 350 134 134 134 136 0 0 0 0 0 0 0 0 0 0 0 0 0 0 0 0 0 0 0 0 0 0 0 0 0 0 0 0 0 697 698 699 700 701 0 0 0 0 0 0 0 0 0 0 0 0 0 0 0
0 0 0 0 0 0 0 0 0 0 0 0 0 0 392 393 471 376 471 471 428 471 376 471 376 372 428 471 471 471 471 471 471 372 473 473 376 473 473 421 0 0 0 0 0 0 660 661 662 663 0 0 0 0 0 0 0 0 0 0 0 0 0 0 0 0 0 0 0 722 723 724 725 726 727 728 0 0 0 0 0 0 0 0 0 0 0 0 0 0
0 0 0 0 0 0 0 0 0 0 0 0 0 0 0 419 471 538 471 471 428 471 471 538 471 471 428 471 471 471 471 471 471 473 473 473 473 473 473 421 0 0 0 0 0 685 686 687 688 689 690 0 0 0 0 0 0 0 0 0 0 0 0 0 0 0 0 0 0 0 749 750 751 752 753 754 0 0 0 0 0 0 0 0 0 0 0 0 0 0
0 0 0 0 0 0 0 0 0 0 0 0 0 0 444 445 471 471 471 471 454 471 471 471 471 471 428 471 471 471 471 471 471 473 473 473 473 473 473 447 448 0 0 0 710 711 712 713 714 715 716 717 0 0 184 184 184 184 184 184 0 0 0 0 0 0 0 0 0 0 775 776 777 778 779 780 0 0 0 0 0 0 0 0 0 0 770 771 772 0
0 0 184 184 184 186 0 782 783 0 0 0 0 0 470 471 920 920 920 479 480 481 471 471 787 473 428 471 471 471 471 471 471 678 473 473 473 473 473 473 474 0 186 0 0 737 738 739 740 741 742 0 0 380 382 382 382 382 382 382 382 384 0 0 0 0 0 0 0 0 801 802 803 804 805 806 0 271 0 0 0 0 0 0 271 0 796 797 798 0
28 28 28 28 28 28 28 28 28 28 0 0 0 28 34 34 34 34 34 34 34 34 34 34 34 34 34 34 121 473 471 471 703 704 705 473 787 40 41 34 30 30 30 127 0 0 0 765 766 0 0 0 0 0 392 393 473 473 473 473 421 0 0 770 771 772 0 125 30 30 30 30 30 30 30 30 30 32 272 272 272 272 272 272 28 30 30 30 30 30
82 188 82 82 82 188 82 190 82 84 0 0 0 80 82 82 188 82 190 82 82 82 188 82 82 190 82 69 147 121 473 473 729 730 731 119 34 66 67 82 190 82 82 153 127 0 0 791 792 0 0 0 0 0 0 419 473 486 473 473 447 448 0 796 797 798 125 151 188 82 190 82 82 188 188 188 82 84 0 0 0 0 0 0 80 82 188 82 190 82
82 82 82 190 82 82 82 82 82 86 87 0 0 80 190 82 82 82 82 82 82 82 82 82 82 82 82 190 82 147 34 34 268 34 34 145 82 82 82 82 82 82 82 188 153 30 30 30 30 30 30 49 50 0 444 445 473 473 473 486 473 474 125 30 30 30 151 188 82 82 82 82 82 82 82 82 190 84 0 0 0 0 0 0 80 190 82 82 82 82
82 82 82 82 82 82 82 82 82 84 0 0 0 80 82 82 82 82 190 82 82 82 82 82 82 82 82 82 82 82 82 84 268 80 82 82 82 82 82 82 82 82 82 82 82 190 82 82 188 82 82 75 76 30 30 30 30 30 30 30 30 30 151 82 82 190 82 82 82 82 82 82 82 82 82 82 82 84 0 0 0 0 0 0 80 82 82 82 82 82
82 82 82 82 82 82 82 190 82 86 139 87 0 80 82 82 82 82 82 82 82 82 82 82 82 190 82 82 82 190 82 84 268 80 82 190 82 190 82 82 190 82 82 82 82 82 82 82 82 82 82 188 82 190 82 188 82 190 82 188 82 82 82 82 82 82 82 82 190 82 82 82 190 82 82 82 82 84 0 0 0 0 0 0 80 82 82 82 190 82
82 82 82 82 82 82 82 82 82 84 0 0 0 80 82 82 82 82 82 82 82 82 82 82 82 82 82 82 82 82 82 84 268 80 82 82 82 82 82 82 82 82 82 82 82 190 82 82 82 82 82 82 82 82 82 82 82 82 82 82 82 82 82 82 82 82 82 82 82 82 82 82 82 82 82 82 82 84 0 0 0 0 0 0 80 82 82 82 82 82
82 82 82 82 82 82 82 82 82 84 0 0 0 80 82 82 82 82 82 82 82 82 82 82 82 82 82 82 82 82 82 84 268 80 82 82 82 522 82 82 82 82 82 524 525 82 82 82 82 82 82 190 82 82 82 82 82 82 190 82 82 82 82 82 82 82 82 82 82 82 82 82 190 82 82 82 82 84 0 0 0 0 0 0 80 82 82 82 190 82
82 82 82 82 82 82 82 82 82 84 0 0 0 132 134 134 134 134 134 134 134 134 302 348 306 134 134 134 134 134 134 306 268 302 134 134 522 522 134 348 134 346 522 550 551 522 134 134 134 134 134 134 134 134 134 134 134 134 134 134 134 134 134 134 522 82 82 82 190 82 82 82 82 82 82 82 82 84 0 0 0 0 0 0 80 82 82 82 190 82
82 82 82 82 82 82 82 82 82 84 0 0 0 419 473 473 473 428 868 868 868 473 473 374 473 473 473 473 428 473 473 473 268 473 428 473 473 473 473 374 473 372 473 473 473 473 473 473 473 473 473 473 473 473 473 473 473 473 473 473 473 473 473 473 254 190 82 82 82 82 82 82 190 82 82 82 82 84 0 0 0 0 0 0 80 82 82 82 82 82
82 82 82 82 82 82 82 82 82 84 0 0 0 419 473 428 473 428 473 473 473 473 473 400 473 473 473 473 428 473 473 473 268 473 428 473 473 473 473 400 473 473 473 434 435 436 473 473 473 473 473 880 473 473 473 434 435 436 473 473 473 473 473 473 254 82 82 82 190 82 82 82 82 82 82 82 82 84 0 0 0 0 0 0 80 82 82 82 190 82
82 82 82 82 82 82 82 82 82 84 0 0 0 419 473 473 473 428 473 434 435 436 473 473 473 927 928 473 428 473 473 473 268 473 428 473 473 473 473 473 846 847 471 473 473 473 473 924 927 928 924 924 473 473 473 473 473 473 473 473 434 435 436 473 254 190 82 82 82 82 82 82 190 82 82 82 82 84 0 0 0 0 0 0 80 82 82 82 190 82
82 82 82 82 82 82 82 82 82 84 0 0 0 419 473 473 473 428 473 473 473 473 473 473 473 473 473 473 428 473 473 473 268 473 428 473 473 927 928 473 872 873 471 473 924 473 473 473 473 473 473 473 473 473 473 473 431 432 473 473 473 473 473 473 254 82 82 82 190 82 82 82 82 82 82 82 82 84 0 0 0 0 0 0 80 82 82 82 82 82
82 82 82 82 82 82 82 82 82 84 0 0 0 419 473 886 887 428 534 535 536 473 473 473 473 473 473 473 454 473 473 473 268 473 428 473 473 473 473 473 473 473 473 473 473 473 473 473 473 473 473 434 435 436 524 525 457 458 473 849 850 473 473 473 254 190 82 82 82 82 82 82 190 82 82 82 82 84 0 0 0 0 0 0 80 82 82 82 190 82
82 82 82 82 82 82 82 82 82 84 0 0 0 419 473 912 913 428 560 916 562 473 473 473 473 473 473 479 480 481 473 473 473 473 428 473 473 920 920 920 920 920 920 920 920 918 920 920 920 920 920 920 920 920 550 551 483 484 473 875 876 473 878 473 254 82 82 82 82 82 82 82 82 82 82 82 82 84 0 0 0 0 0 0 80 82 82 82 190 82
82 82 82 82 82 82 82 82 82 84 0 0 0 198 200 200 200 200 200 200 200 200 200 200 200 200 200 200 200 200 200 522 200 200 200 200 200 200 200 200 200 200 200 200 200 200 200 200 200 200 200 200 200 200 200 200 200 200 200 200 200 200 200 200 522 190 82 82 190 82 82 82 190 82 82 82 82 84 0 0 0 0 0 0 80 82 82 82 82 82
82 82 82 82 82 82 82 82 82 84 0 0 0 250 82 82 82 82 190 82 82 82 82 82 82 190 82 82 82 82 82 82 82 522 524 525 82 82 82 82 190 82 82 82 82 82 82 82 82 82 82 190 82 82 82 190 82 82 82 190 82 82 82 82 82 82 82 82 82 82 82 82 82 82 82 82 82 84 0 0 0 0 0 0 80 82 82 82 190 82
82 82 82 82 82 82 82 82 82 84 0 0 0 250 82 82 82 82 82 82 82 82 82 82 82 82 82 82 82 82 82 82 82 82 550 551 522 82 82 82 82 82 82 82 82 82 190 82 82 82 82 82 82 82 82 82 82 82 82 82 82 82 82 82 82 190 82 82 190 82 82 82 190 82 82 82 82 84 0 0 0 0 0 0 80 82 82 82 190 82
82 82 82 82 82 82 82 82 82 84 0 0 0 250 82 82 82 82 190 82 82 82 82 82 82 190 82 82 82 82 82 82 82 82 82 522 82 82 82 190 82 82 82 82 82 82 82 82 82 82 82 190 82 82 82 190 82 82 82 190 82 82 82 82 82 82 82 82 82 82 82 82 82 82 82 82 82 84 0 0 0 0 0 0 80 82 82 82 82 82